Мастер и Маргарита - Михаил Булгаков
Преступление и наказание - Федор Михайлович Достоевский
Маленький принц - Антуан де Сент-Экзюпери
Собачье сердце - Михаил Булгаков
Три товарища - Эрих Мария Ремарк
Над пропастью во ржи - Джером Сэлинджер
Герой нашего времени - Михаил Лермонтов
Приключения Шерлока Холмса - Артур Конан Дойл
Портрет Дориана Грея - Оскар Уайльд
Властелин колец - Джон Рональд Руэл Толкин
Крестный отец - Марио Пьюзо
Триумфальная арка - Эрих Мария Ремарк
Мертвые души - Николай Васильевич Гоголь
Поющие в терновнике - Колин Маккалоу
Грозовой перевал - Эмили Бронте
На западном фронте без перемен - Эрих Мария Ремарк
Демиан - Герман Гессе
Зеленая миля - Стивен Кинг
Сто лет одиночества - Габриэль Гарсиа Маркес
Собор Парижской Богоматери - Виктор Гюго
Робинзон Крузо - Даниель Дефо
Приключения Алисы в стране чудес - Льюис Кэрролл
По ком звонит колокол - Эрнест Хемингуэй
Мартин Иден - Джек Лондон
Понедельник начинается в субботу - Аркадий и Борис Стругацкие
Мы - Евгений Замятин
Прощай, оружие! - Эрнест Хемингуэй
Доктор Живаго - Борис Пастернак
Камера обскура - Владимир Набоков
Фауст - Иоганн Вольфганг Гёте
Божественная комедия - Данте Алигьери
Заводной апельсин - Энтони Берджесс
Чапаев и Пустота - Виктор Пелевин
Повелитель мух - Уильям Голдинг
Чума - Альбер Камю
Сегун - Джеймс Клавелл
Марсианские хроники - Рэй Брэдбери
Солярис - Станислав Лем
Степной волк - Герман Гессе
Невыносимая легкость бытия - Милан Кундера
Пена дней - Борис Виан
Осиная Фабрика - Иэн Бэнкс
Мир глазами Гарпа - Джон Ирвинг
Английский пациент - Майкл Ондатже
Унесенные ветром - Маргарет Митчелл
451 градус по Фаренгейту - Рэй Брэдбери
Парфюмер. История одного убийцы - Патрик Зюскинд
1984 - Джордж Оруэлл
Белый Клык - Джек Лондон
Гордость и предубеждение - Джейн Остен
12 стульев - Евгений Петров и Илья Ильф
Идиот - Федор Достоевский
Джейн Эйр - Шарлота Бронте
Старик и море - Эрнест Хемингуэй
Великий Гэтсби - Фрэнсис Скотт Фицджеральд
Три мушкетера - Александр Дюма
Над кукушкиным гнездом - Кен Кизи
Убить пересмешника - Харпер Ли
Отверженные - Виктор Гюго
Человек который смеется - Виктор Гюго
Лолита - Владимир Набоков
Пикник на обочине - Аркадий и Борис Стругацкие
Чайка по имени Джонатан Ливингстон - Ричард Бах
Империя ангелов - Бернард Вербер
Овод - Этель Лилиан Войнич
Коллекционер - Джон Фаулз
Айвенго - Вальтер Скотт
Чтец - Бернхард Шлинк
Атлант расправил плечи. Трилогия - Айн Рэнд
Замок - Франц Кафка
Театр - Сомерсет Моэм
О дивный новый мир - Олдос Хаксли
Имя розы - Умберто Эко
Лабиринты Ехо - Макс Фрай
Посторонний - Альбер Камю
Бремя страстей человеческих - Сомерсет Моэм
На игле - Ирвин Уэлш
Моби Дик - Герман Мелвилл
Поправка-22 - Джозеф Хеллер
Шум и ярость - Уильям Фолкнер
Улисс - Джеймс Джойс
Гарри Поттер - Джоан Роулинг
Хроники Амбера - Роджер Желязны
Сага о ведьмаке - Анджей Сапковский
Отец Горио - Оноре де Бальзак
Жестяной барабан - Гюнтер Грасс
Завтра была война - Борис Васильев
Красное и черное - Стендаль
Война и мир - Лев Толстой
Госпожа Бовари - Гюстав Флобер
Бойцовский клуб - Чак Паланик
Книжный вор - Маркус Зусак
Евгений Онегин - Александр Пушкин
Песнь Льда и Пламени - Джордж Мартин
Облачный атлас - Дэвид Митчелл
Тёмная Башня (серия книг) - Стивен Кинг
Норвежский лес - Харуки Мураками
Марсианин - Энди Вейр
Отцы и дети - Иван Тургенев
В ожидании Годо - Сэмюэль Беккет
